0:7:0 0:16:22
1:7:0 0:16:22
2:7:0 0:16:22
2:6:0 0:16:22
0:6:0 0:16:22
1:6:0 0:16:22
0:8:0 0:16:22
1:8:0 0:16:22
2:8:0 0:16:22
0:9:0 0:16:22
1:9:0 0:16:22
2:9:0 0:16:22
3:9:0 0:16:22
3:8:0 0:16:22
3:7:0 0:16:22
3:6:0 0:16:22
4:6:0 0:16:22
4:7:0 0:16:22
4:8:0 0:16:22
4:9:0 0:16:22
4:5:0 0:16:22
3:5:0 0:16:22
4:4:1 0:16:22
3:4:1 0:16:22
3:4:2 0:16:22
4:4:2 0:16:22
4:3:3 0:16:22
3:3:3 0:16:22
3:3:2 0:16:22
4:3:2 0:16:22
4:2:4 0:16:22
3:2:4 0:16:22
3:2:3 0:16:22
4:2:3 0:16:22
4:1:4 0:16:22
3:1:4 0:16:22
3:0:4 0:16:22
4:0:4 0:16:22
0:0:0 0:16:22
0:1:0 0:16:22
0:2:0 0:16:22
0:3:0 0:16:22
0:4:0 0:16:22
0:5:0 0:16:22
5:9:0 0:16:22
5:8:0 0:16:22
5:7:0 0:16:22
5:6:0 0:16:22
6:6:0 0:16:22
6:7:0 0:16:22
6:8:0 0:16:22
6:9:0 0:16:22
6:5:0 0:16:22
6:4:0 0:16:22
7:4:0 0:16:22
7:5:0 0:16:22
7:6:0 0:16:22
1:5:0 0:16:22
2:5:0 0:16:22
5:4:1 0:16:22
5:5:0 0:16:22
