0:0:0 0:16:22
0:1:0 0:16:22
0:2:0 0:16:22
1:1:0 0:16:22
2:1:0 0:16:22
2:0:0 0:16:22
