1:3:0 0:16:22
2:3:0 0:16:22
2:4:0 0:16:22
1:4:0 0:16:22
0:4:0 0:16:22
0:4:1 0:16:22
0:4:2 0:16:22
0:4:3 0:16:22
1:4:3 0:16:22
2:4:3 0:16:22
3:4:3 0:16:22
3:4:2 0:16:22
3:4:1 0:16:22
3:4:0 0:16:22
3:3:0 0:16:22
3:2:0 0:16:22
2:2:0 0:16:22
1:2:0 0:16:22
1:1:0 0:16:22
2:1:0 0:16:22
3:1:0 0:16:22
3:0:0 0:16:22
2:0:0 0:16:22
1:0:0 0:16:22
1:4:4 0:16:22
2:4:4 0:16:22
